**X**XXXX
*********
*X*XXX*XX
*X***X*X*
*XX**X***
***X*XXXX
***X*X***
*X*XXXX**
*X*X*X*X*
*X***X***
